two-factor authentication; 2FA	استيثاق ثنائي.	authentication MFA
administrator; admin	مُدِير (ج: مُدِيرون).  الفعل: أدار يُدير إدارةً، والأمر: أدِر، والمفعول: أُدير يُدار فهو مُدار.	@ moderator sysadmin
authenticate; authentication	الاسم: اسْتِيثَاق (ج: اسْتِيثَاقَات).  الفعل: استَوثَق يَستَوثِق استيثاقًا، والأمر: استَوثِق، والمفعول: اُستُوثِق يُستُوثَق فهو مُستَوثَق.	@ 2FA MFA
blur	الاسم: تضبيب.  الفعل ضَبَّب يُضَبِّب تضبيبًا، والأمر: ضَبِّب، والمفعول: ضُبِّب يُضَبَّب فهو مُضَبَّب.	@
check in	{{في أنظمة إدارة النسخ}} الاسم: إيداع (ج: إيداعات).  الفعل: أَوْدَع يُودِع إيداعًا فهو مُودِع، والأمر أَوْدِع، والمفعول: أُودِع يُودَع فهو مُودَع.	commit
clone	الاسم: استِنساخ (ج: استِنساخات).  الفعل: استَنسَخ يَستَنسِخ استِنساخًا فهو مُستَنسِخ، والأمر: استَنسِخ، والمفعول: اُستُنسِخ يُستَنسَخ فهو مُستَنسَخ.	@
color scheme	نَسَق ألوان (ج: أنساق ألوان).	theme
commit	{{في أنظمة إدارة النسخ}} الاسم: إيداع (ج: إيداعات).  الفعل: أَوْدَع يُودِع إيداعًا فهو مُودِع، والأمر أَوْدِع، والمفعول: أُودِع يُودَع فهو مُودَع.	@ repository
computer	حاسوب (ج: حواسيب)؛ أو حاسب [آلي] (ج: حاسبات [آلية]).	@ laptop
contrast	تبايُن.	high_contrast
crypto-	صفة: تَعمَوِيّ، تَعمَوِيَّة.	@ encrypt cryptocurrency
cryptocurrency	عُمْلَة تَعمَوِيَّة (ج: عملات تعموية).	@ crypto-
encrypt; encryption	المصدر: تَعمِيَة.  الفعل: عَمَّى يُعمِّي تَعمِيَةً فهو مُعَمٍّ (المُعَمِّي)، والأمر: عَمِّ، والمفعول: عُمِّيَ يُعَمَّى فهو مُعَمَّى.	@
federated; federation	الصفة: اتِّحاديّ، اتِّحاديَّة.  الاسم: اتِّحاد (ج: اتِّحادات).	@
filter	الاسم: تصفيَة (ج: تصفيات، أو لا يُجمع).  الفعل: صَفَّى يُصَفِّي تصفيَةً فهو مُصفِّي، والأمر: صَفِّ. والمفعول: صُفِّيَ يُصَفَّى فهو مُصَفَّى.  اسم الآلة مِصفاة (ج: مِصفاوات).	@
firewall	جِدار حماية (ج: جُدران حماية).
high contrast	الصفة: عالي التبايُن، عالية التبايُن.  الاسم: تبايُن عالٍ، التبايُن العالي.	@ contrast
instance	نُسْخَة (ج: نُسَخ).	@
laptop	حاسوب محمول (ج: حواسيب محمولة).	computer
multi-factor authentication; MFA	استيثاق متعدد العوامل.	2FA authentication
mode	وَضْع (ج: أوضاع).
moderator	مُشرِف (ج: مُشرِفون).  الفعل: أشرَف يُشرف إشرافًا.
protocol	ميفاق (ج: موافيق).	@
repository	مُسْتَوْدَع (ج: مُسْتَوْدَعَات).	@ commit
sandbox	الاسم: مَعزِل (ج: مَعَازِل).  الفعل: عَزَل يَعزِل عَزْلًا. والأمر: اعزِل، والمفعول: عُزِل يُعزَل فهو معزول.	@
system administrator; sysadmin	مدير النظام (ج: مديرو النظام).	admin
telephone	هاتف (ج: هواتف).
theme	نَسَق (ج: أنساق).	@ color_scheme
